1;1;N;2;2;N;1;1;1;1
C;1;1;2;2;2;CC;1;1;1
1;2;2;N;1;1;P;1;X;X
X;X;N;1;1;1;2;C;2;1
CN;2;1;1;1;N;1;1;1;2
1;C;1;1;1;X;X;X;1;1
N;2;2;1;1;1;N;1;1;1
